 , , , , , , , , , , , , , , , , , , , , , , ,≈,≈,≈, , , , , , , 
 ,┌,─,─,┐, , ,┌,-,-,-,-,-,-,-,┐, , , , , , , ,≈,≈,≈, , , , , , , 
 ,│, , ,│, , ,¦, , , , , , , ,¦, , , , , , , ,≈,≈,≈, , , , , , , 
 ,│, , ,│, , ,¦, , , , , , , ,¦, , , , , , , ,≈,≈,≈, , , , , , , 
 ,└, ,─,┘, , ,¦, , , , , , , ,¦, , , , , , ,≈,≈,≈, , , , , , , , 
 , , , , , , ,¦, , , , , , , ,¦, , , , , , ,≈,≈,≈, , , , , , , , 
 , , , , , , ,└,-,-,-,═,-,-,-,┘, , , , , , ,≈,≈,≈, , , , , , , , 
 , , , , , , , , , , , , , , , , , , , , , ,≈,≈,≈, , , , , , , , 
 , , , , , , , , , , , , , , , , , , , , , ,≈,≈,≈, , , , , , , , 
 , , , , , , , , , , , , , , , , , , , , ,≈,≈,≈, , , , , , , , , 
 , ,┌, ,┐, , ,╔,═, ,═,╗, , , , , , , , , ,─,─,─, , , , , , , , , 
 , ,│, ,│, , ,║, , , ,║, , , , , , , , , , , , , , , , , , , , , 
 , ,└,─,┘, , ,║, , , ,║, , , , , , , , , ,─,─,─, , , , , , , , , 
 , ,┌,─,─,┐, ,╚,╗, ,╔,╝, , , , , , , , , ,≈,≈,≈, , , , , , , , , 
 , , , , ,│, , ,╚,═,╝, , , , , , , , , ,≈,≈,≈, , , , , , , , , , 
 , ,└,─,─,┘, , , , , , , , , , , , , , ,≈,≈,≈, , , , , , , , , , 