 , , , , , , , , , , , , , , , , , , , , , ,|,≈,≈,≈,|, , , , , , 
 ,┌,─,─,┐, , ,┌,┄,┄,┄,┄,┄,┄,┄,┐, , , , , , ,|,≈,≈,≈,|, , , , , , 
 ,│, , ,│, , ,┆, , , , , , , ,┆, , , , , , ,|,≈,≈,≈,|, , , , , , 
 ,│, , ,│, , ,┆, , , , , , , ,┆, , , , , , ,/,≈,≈,≈,|, , , , , , 
 ,└, ,─,┘, , ,┆, , , , , , , ,┆, , , , , ,|,≈,≈,≈,/, , , , , , , 
 , ,⁖, , , , ,┆, , , , , , , ,┆, , , , , ,|,≈,≈,≈,|, , , , , , , 
 , ,⁖, , , , ,└,┄,┄,┄,═,┄,┄,┄,┘, , , , , ,|,≈,≈,≈,|, , , , , , , 
 , ,⁖, , , , , , , , ,⁖, , , , , , , , , ,|,≈,≈,≈,|, , , , , , , 
 ,⁖,⁖,⁖,⁖,⁖,⁖,⁖,⁖,⁖,⁖,⁖,⁖, , , , , , , , ,/,≈,≈,≈,|, , , , , , , 
 ,⁖, ,⁖, , , , , ,⁖, , ,⁖, , , , , , , ,|,≈,≈,≈,/, , , , , , , , 
 ,⁖,┌, ,┐, , ,╔,═, ,═,╗,⁖, , , , , , , ,|,≈,≈,≈,|, , , , , , , , 
 ,⁖,│, ,│, , ,║, , , ,║,⁖,⁖,⁖,⁖,⁖,⁖,⁖,⁖,□,◫,◫,◫,□, ,⁖,⁖,⁖,⁖,⁖,⁖, 
 ,⁖,└,─,┘, , ,║, , , ,║, , , , , , , , ,|,≈,≈,≈,|, , , , , , , , 
 ,⁖,┌,─,─,┐, ,╚,╗, ,╔,╝, , , , , , , , ,/,≈,≈,≈,|, , , , , , , , 
 ,⁖, , , ,│, , ,╚,═,╝, , , , , , , , ,|,≈,≈,≈,/, , , , , , , , , 
 , ,└,─,─,┘, , , , , , , , , , , , , ,|,≈,≈,≈,|, , , , , , , , , 